ang - pol - nazwa_kategorii - opis/zdj
cat - kot - zwierzęta
dog - pies - zwierzęta
fish - ryba - zwierzęta
cow - krowa - zwierzęta
pig - świnia - zwierzęta
sheep - owca - zwierzęta
horse - koń - zwierzęta
bird - ptak - zwierzęta
red - czerwony - kolory
blue - niebieski - kolory
yellow - żółty - kolory
green - zielony - kolory
brown - brązowy - kolory
black - czarny - kolory
white - biały - kolory
grey - szary - kolory
orange - pomarańczowy - kolory
coat - płaszcz - ubrania
skirt - spódnica - ubrania
hat - kapelusz - ubrania
shoes - buty - ubrania
shirt - koszula - ubrania
trousers - spodnie - ubrania
jeans - dżinsy - ubrania
sugar - cukier - jedzenie
meat - mięso - jedzenie
ice cream - lody - jedzenie
egg - jajko - jedzenie
bread - chleb - jedzenie
chocolate - czekolada - jedzenie
biscuit - herbatnik - jedzenie
rice - ryż - jedzenie
cheese - ser - jedzenie
vegetable - warzywo - jedzenie
fruit - owoc - jedzenie
drink - napój - jedzenie
ticket - bilet - wakacje
to eat - jeść - czynności
to write - pisać - czynności
to sleep - spać - czynności
to read - czytać - czynności
to look - patrzeć - czynności
to smile - uśmiechać się - czynności
to walk - iść - czynności
to run - biec - czynności
to draw - rysować - czynności
to speak - mówić - czynności
to play - grać - czynności
to listen - słuchać - czynności
to sing - śpiewać - czynności
to travel - podróżować - czynności
to meet - spotykać - czynności
to teach - uczyć - czynności
to stand - stać - czynności
to join - dołączać - czynności
to improve - ulepszać - czynności
to choose - wybierać - czynności
to think - myśleć - czynności
dog - pies - zwierzęta
arm - ramię - części ciała
eye - oko - części ciała
nose - nos - części ciała
ear - ucho - części ciała
head - głowa - części ciała
face - twarz - części ciała
hair - włosy - części ciała
mouth - usta - części ciała
hand - dłoń - części ciała
leg - noga - części ciała
foot - stopa - części ciała
body - ciało - części ciała
airplane - samolot - środki transportu
boat - łódź - środki transportu
bus - autobus - środki transportu
car - samochód - środki transportu
taxi - taksówksa - środki transportu
train - pociąg - środki transportu
cold - przeziębienie - zdrowie
ball - piłka - sport i rekreacja
basketball - koszykówka - sport i rekreacja
doll - lalka - sport i rekreacja
football - piłka nożna - sport i rekreacja
game - gra - sport i rekreacja
player - gracz - sport i rekreacja
sport - sport - sport i rekreacja
swimming pool - basen - sport i rekreacja
swim - pływać - sport i rekreacja
tennis - tenis - sport i rekreacja
brother - brat - rodzina
child - dziecko - rodzina
children - dzieci - rodzina
dad - tata - rodzina
daughter - córka - rodzina
father - ojciec - rodzina
husband - mąż - rodzina
mother - matka - rodzina
mum - mama - rodzina
parents - rodzice - rodzina
sister - siostra - rodzina
son - syn - rodzina
wife - żona - rodzina
bath - wanna - dom i jego wyposażenie
shower - prysznic - dom i jego wyposażenie
toilet - toaleta - dom i jego wyposażenie
bathroom - łazienka - dom i jego wyposażenie
bedroom - sypialnia - dom i jego wyposażenie
dining room - jadalnia - dom i jego wyposażenie
kitchen - kuchnia - dom i jego wyposażenie
living room - salon - dom i jego wyposażenie
knife - nóż - dom i jego wyposażenie
cold - zimno - zjawiska atmosferyczne
hot - gorąco - zjawiska atmosferyczne
rain - deszcz - zjawiska atmosferyczne
snow - śnieg - zjawiska atmosferyczne
summer - lato - zjawiska atmosferyczne
sun - słońce - zjawiska atmosferyczne
warm - ciepły - zjawiska atmosferyczne
weather - pogoda - zjawiska atmosferyczne
wind - wiatr - zjawiska atmosferyczne
winter - zima - zjawiska atmosferyczne
cook - kucharz - zawody
doctor - lekarz - zawody
driver - kierowca - zawody
teacher - nauczyciel - zawody
waiter - kelner - zawody
waitress - kelnerka - zawody
clock - zegar - dom i jego wyposażenie
chair - krzesło - dom i jego wyposażenie
computer - komputer - dom i jego wyposażenie
April - kwiecień - miesiące
August - sierpień - miesiące
December - grudzień - miesiące
February - luty - miesiące
January - styczeń - miesiące
July - lipiec - miesiące
June - czerwiec - miesiące
March - marzec - miesiące
May - maj - miesiące
November - listopad - miesiące
October - październik - miesiące
September - wrzesień - miesiące
afternoon - popołudnie - pory dnia
evening - wieczór - pory dnia
morning - poranek - pory dnia
night - noc - pory dnia
