ang - pol - nazwa_kategorii - opis/zdj
rabbit - królik - zwierzęta
mouse - mysz - zwierzęta
elephant - słoń - zwierzęta
snake - wąż - zwierzęta
monkey - małpa - zwierzęta
duck - kaczka - zwierzęta
pink - różowy - kolory
purple - fioletowy - kolory
jumper - sweter - ubrania
trainers - buty sportowe - ubrania
candy - cukierek - jedzenie
tourist - turysta - wakacje
suitcase - walizka - wakacje
passport - paszport - wakacje
airport - lotnisko - wakacje
sock - skarpeta - ubrania
to exercise - ćwiczyć - czynności
to decide - decydować - czynności
to throw - rzucać - czynności
to follow - podążać za kimś - czynności
bill - rachunek - zakupy
change - reszta - zakupy
cheque - czek - zakupy
receipt - paragon - zakupy
sale - wyprzedaż - zakupy
back - plecy - części ciała
neck - szyja - części ciała
finger - palec u ręki - części ciała
toe - palec u nogi - części ciała
brain - mózg - części ciała
heart - serce - części ciała
stomach - żołądek - części ciała
ambulance - karetka - środki transportu
bicycle - rower - środki transportu
coach - autokar - środki transportu
helicopter - helikopter - środki transportu
motorbike - motocykl - środki transportu
scooter - skuter - środki transportu
ship - statek - środki transportu
underground - metro - środki transportu
tram - tramwaj - środki transportu
activity - aktywność - sport i rekreacja
badminton - badminton - sport i rekreacja
baseball - bejsbol - sport i rekreacja
bat - kij - sport i rekreacja
bathing suit - strój kąpielowy - sport i rekreacja
board - plansza - sport i rekreacja
board game - gra planszowa - sport i rekreacja
card game - gra karciana - sport i rekreacja
chess - szachy - sport i rekreacja
climbing - wspinaczka - sport i rekreacja
club - klub - sport i rekreacja
competition - zawody - sport i rekreacja
cricket - krykiet - sport i rekreacja
cycling - kolarstwo - sport i rekreacja
fishing - łowienie ryb - sport i rekreacja
footballer - piłkarz - sport i rekreacja
goal - bramka - sport i rekreacja
golf - golf - sport i rekreacja
hobby - hobby - sport i rekreacja
hockey - hokej - sport i rekreacja
kit - ekwipunek - sport i rekreacja
match - mecz - sport i rekreacja
member - członek - sport i rekreacja
playground - plac zabaw - sport i rekreacja
pool - basen - sport i rekreacja
practice - praktyka - sport i rekreacja
prize - nagroda - sport i rekreacja
puzzle - układanka - sport i rekreacja
quiz - teleturniej - sport i rekreacja
race - wyścig - sport i rekreacja
racket - rakieta - sport i rekreacja
riding - jazda konna - sport i rekreacja
rugby - rugby - sport i rekreacja
runner - biegacz - sport i rekreacja
running - bieganie - sport i rekreacja
sailing - żeglarstwo - sport i rekreacja
skateboard - deskoroloka - sport i rekreacja
skateboarding - jazda na deskorolce - sport i rekreacja
skating - jazda na łyżwach - sport i rekreacja
skiing - narciarstwo - sport i rekreacja
soccer - piłka nożna - sport i rekreacja
sports centre - centrum rekreacyjne - sport i rekreacja
stadium - stadion - sport i rekreacja
surf - surfować - sport i rekreacja
swimming - pływanie - sport i rekreacja
table tenis - tenis stołowy - sport i rekreacja
team - drużyna - sport i rekreacja
toy - zabawka - sport i rekreacja
versus - przeciwko - sport i rekreacja
video game - gra wideo - sport i rekreacja
volleyball - siatkówka - sport i rekreacja
winner - zwycięzca - sport i rekreacja
aunt - ciotka - rodzina
big brother - starszy brat - rodzina
big sister - starsza siostra - rodzina
cousin - kuzyn - rodzina
grandchild - wnuk - rodzina
grandchildren - wnuczęta - rodzina
granddad - dziadek - rodzina
granddaughter - wnuczek - rodzina
grandfather - dziadek - rodzina
grandma - babcia - rodzina
grnadomother - babka - rodzina
grandpa - dziadek - rodzina
grandparents - dziadkowie - rodzina
uncle - wujek - rodzina
bowl - miska - dom i jego wyposażenie
cooker - kuchenka - dom i jego wyposażenie
cupboard - szafka - dom i jego wyposażenie
drawer - szuflada - dom i jego wyposażenie
fork - widelec - dom i jego wyposażenie
fridge - lodówka - dom i jego wyposażenie
kitchen table - stół kuchenny - dom i jego wyposażenie
microwave - mikrofalówka - dom i jego wyposażenie
shelf - półka - dom i jego wyposażenie
sink - zlew - dom i jego wyposażenie
spoon - łyżka - dom i jego wyposażenie
garage - garaż - dom i jego wyposażenie
hall - przedpokój - dom i jego wyposażenie
sitting room - pokój dzienny - dom i jego wyposażenie
bathroom cabinet - szafka łazienkowa - dom i jego wyposażenie
towel - ręcznik - dom i jego wyposażenie
wasching machine - pralka - dom i jego wyposażenie
cloud - chmura - zjawiska atmosferyczne
cloudy - zachmurzony - zjawiska atmosferyczne
fog - mgła - zjawiska atmosferyczne
foggy - mglisty - zjawiska atmosferyczne
ice - lód - zjawiska atmosferyczne
spring - wiosna - zjawiska atmosferyczne
storm - sztorm - zjawiska atmosferyczne
sunny - słoneczny - zjawiska atmosferyczne
thunderstorm - burza z piorunami - zjawiska atmosferyczne
wet - mokry - zjawiska atmosferyczne
windy - wietrzny - zjawiska atmosferyczne
fire - pożar - zjawiska atmosferyczne
actor - aktor - zawody
actress - aktorka - zawody
artist - artysta - zawody
businessman - biznesmen - zawody
businesswoman - biznesmenka - zawody
car mechanic - mechanik samochodowy - zawody
chef - szef kuchni - zawody
chemist - aptekarz - zawody
cleaner - sprzątacz - zawody
dancer - tancerz - zawody
dentist - dentystka - zawody
engineer - inżynier - zawody
farmer - rolnik - zawody
guide - przewodnik - zawody
headteacher - dyrektor szkoły - zawody
manager - menedżer - zawody
mechanic - mechanik - zawody
nurse - pielęgniarka - zawody
painter - malarz - zawody
photographer - fotograf - zawody
pilot - pilot - zawody
police officer - policjant - zawody
policeman - policjant - zawody
policewoman - policjantka - zawody
recepcionist - recepcjonista - zawody
salesperson - sprzedawca - zawody
secretary - sekretarz - zawody
singer - piosenkarz - zawody
taxi driver - taksówkarz - zawody
tour gide - przewodnik wycieczek - zawody
writer - pisarz - zawody
cupboard - szafka - dom i jego wyposażenie
drawer - szuflada - dom i jego wyposażenie
lamp - lampa - dom i jego wyposażenie
printer - drukarka - dom i jego wyposażenie
