ang - pol - nazwa_kategorii - opis/zdj
fox - lis - zwierzęta
bear - niedźwiedź - zwierzęta
cello - wiolonczela - instrumenty
strings - struny - instrumenty
almond - migdał - jedzenie
bean - fasola - jedzenie
cabbage - kapusta - jedzenie
carbohydrates - węglowodany - jedzenie
cauliflower - kalafior - jedzenie
dairy - nabiał - jedzenie
dip - sos - jedzenie
dressing - sos do sałatek - jedzenie
fat - tłuszcz - jedzenie
hazelnut - orzech laskowy - jedzenie
lentils - soczewica - jedzenie
noodles - makaron - jedzenie
olive - oliwka - jedzenie
protein - białko - jedzenie
bill - rachunek - zakupy
budget - budżet - zakupy
coupon - kupon - zakupy
debt - dług - zakupy
savings - oszczędności - zakupy
wealth - bogactwo - zakupy
objection - sprzeciw - słownictwo prawnicze
sentence - wyrok - słownictwo prawnicze
witness - świadek - słownictwo prawnicze
guilty - winny - słownictwo prawnicze
eyelid - powieka - części ciała
gum - dziąsło - części ciała
hip - biodro - części ciała
liver - wątroba - części ciała
lungs - płuca - części ciała
waist - talia - części ciała
eyelash - rzęsa - części ciała
jaw - szczęka - części ciała
heel - pięta - części ciała
chest - klatka piersiowa - części ciała
thigh - udo - części ciała
wrist - nadgarstek - części ciała
nail - paznokieć - części ciała
muscle - mięsień - części ciała
skeleton - szkielet - części ciała
glider - szybowiec - środki transportu
hang glider - lotnia - środki transportu
rocket - rakieta - środki transportu
yacht - jacht - środki transportu
to faint - zemdleć - zdrowie
injury - kontuzja - zdrowie
to shiver - mieć dreszcze - zdrowie
to sneeze - kichać - zdrowie
stroke - wylew - zdrowie
symptom - objaw - zdrowie
wound - rana - zdrowie
to itch - swędzieć - zdrowie
unconscious - nieprzytomny - zdrowie
dizzy - cierpiący na zawroty głowy - zdrowie
bruise - siniak - zdrowie
arrow - strzała - sport i rekreacja
athletic - atletyczny - sport i rekreacja
course - pole - sport i rekreacja
defender - obrońca - sport i rekreacja
hoop - obręcz - sport i rekreacja
hunting - polowanie - sport i rekreacja
lap - okrążenie - sport i rekreacja
lead - czołówka - sport i rekreacja
marathon - maraton - sport i rekreacja
martial arts - sztuki walki - sport i rekreacja
opponent - przeciwnik - sport i rekreacja
participant - uczestnik - sport i rekreacja
pass - podanie - sport i rekreacja
penalty - rzut karny - sport i rekreacja
pitch - boisko - sport i rekreacja
play - zabawa - sport i rekreacja
poker - poker - sport i rekreacja
recreation - rekreacja - sport i rekreacja
referee - sędzia - sport i rekreacja
rope - lina - sport i rekreacja
roulette - ruletka - sport i rekreacja
semi-final - półfinał - sport i rekreacja
set - set - sport i rekreacja
shot - strzał - sport i rekreacja
swing - huśtawka - sport i rekreacja
target - cel - sport i rekreacja
trophy - puchar - sport i rekreacja
victory - zwycięstwo - sport i rekreacja
siblings - rodzeństwo - rodzina
stepdaughter - pasierbica - rodzina
stepfather - ojczym - rodzina
stepmother - macocha - rodzina
stepson - pasierb - rodzina
attic - strych - dom i jego wyposażenie
basement - piwnic - dom i jego wyposażenie
cellar - piwnica - dom i jego wyposażenie
lobby - hol - dom i jego wyposażenie
cloth - ścierka - dom i jego wyposażenie
coffee maker - ekspres do kawy - dom i jego wyposażenie
corkscrew - korkociąg - dom i jego wyposażenie
scales - waga - dom i jego wyposażenie
stool - taboret - dom i jego wyposażenie
bathroom scales - waga łazienkowa - dom i jego wyposażenie
daylight - światło dzienne - zjawiska atmosferyczne
hurricane - huragan - zjawiska atmosferyczne
moonlight - światło księżyca - zjawiska atmosferyczne
rainbow - tęcza - zjawiska atmosferyczne
rainfall - opady - zjawiska atmosferyczne
stormy - burzowy - zjawiska atmosferyczne
twilight - zmierzch - zjawiska atmosferyczne
disaster - katastrofa - zjawiska atmosferyczne
earthquake - trzesięnie ziemi - zjawiska atmosferyczne
tornado - tornado - zjawiska atmosferyczne
analyst - analityk - zawody
banker - bankier - zawody
bodyguard - ochroniarz - zawody
cashier - kasjer - zawody
comedian - komik - zawody
compesor - kompozytor - zawody
conductor - dyrygent - zawody
consultant - konsultant - zawody
critic - krytyk - zawody
dealer - dealer - zawody
diplomat - dyplomata - zawody
driving instructor - instruktor nauki jazdy - zawody
economist - ekonomista - zawody
editor - wydawca - zawody
electrician - elektryk - zawody
factory worker - pracownik fabryki - zawody
flight attendant - steward - zawody
florist - florysta - zawody
gardener - ogrodnik - zawody
graphic designer - grafik - zawody
inspector - inspektor - zawody
insurance agent - agent ubezpieczoniowy - zawody
interior decorator - dekorator wnętrz - zawody
investigator - śledczy - zawody
judge - sędzia - zawody
lecturer - wykładowca - zawody
librarian - bibliotekarz - zawody
lifeguard - ratownik - zawody
novelist - powieściopisarz - zawody
pharmacist - farmaceuta - zawody
plumber - hydrualik - zawody
psychologist - psycholog - zawody
publisher - wydawca - zawody
researcher - badaczka - zawody
shoemaker - szewc - zawody
tailor - krawiec - zawody
ticket inspector - kontroler biletów - zawody
watchmaker - zegarmistrz - zawody
monitor - monitor - dom i jego wyposażenie
