ang - pol - nazwa_kategorii - opis/zdj
hedgehog - jeż - zwierzęta
falcon - sokół - zwierzęta
firefly - świetlik - zwierzęta
mammal - ssak - zwierzęta
reptile - gad - zwierzęta
amphibian - płaz - zwierzęta
beetle - chrząszcz - zwierzęta
carnivore - mięsożerca - zwierzęta
eel - węgorz - zwierzęta
rodent - gryzoń - zwierzęta
gilet - kamizelka - ubrania
cardigan - sweter rozpinany - ubrania
apparel - odzież - ubrania
jersey - koszulka sportowa - ubrania
adoration - uwielbienie - uczucia i emocje
alienation - wyobcowanie - uczucia i emocje
awe - podziw - uczucia i emocje
bliss - rozkosz - uczucia i emocje
contempt - pogarda - uczucia i emocje
dismay - niepokój - uczucia i emocje
envious - zazdrosny - uczucia i emocje
grumpy - zrzędliwy - uczucia i emocje
infatuated - zauroczony - uczucia i emocje
loathing - odraza - uczucia i emocje
misery - nędza - uczucia i emocje
outrage - zniewaga - uczucia i emocje
remorse - wyrzuty sumienia - uczucia i emocje
subdued - przygnębiony - uczucia i emocje
vivacious - pełen życia - uczucia i emocje
accordion - akordeon - instrumenty
bassoon - fagot - instrumenty
brass instruments - instrumenty dęte blaszane - instrumenty
clarinet - klarnet - instrumenty
double bass - kontrabas - instrumenty
harp - harfa - instrumenty
pipe organ - organy - instrumenty
saxophone - saksofon - instrumenty
viola - altówka - instrumenty
xylophone - ksylofon - instrumenty
wind instruments - instrumenty dęte - instrumenty
vein - żyła - części ciała
spine - kręgosłup - części ciała
dumb - niemy - zdrowie
bridge - brydż - sport i rekreacja
dominoes - domino - sport i rekreacja
pad - ochraniacz - sport i rekreacja
triumph - triumf - sport i rekreacja
win - wygrana - sport i rekreacja
bath mat - dywanik łazienkowy - dom i jego wyposażenie
bidet - bidet - dom i jego wyposażenie
flush - spłuczka - dom i jego wyposażenie
soap dispenser - dozownik mydła - dom i jego wyposażenie
sponge - gąbka - dom i jego wyposażenie
tiles - kafelki - dom i jego wyposażenie
toilet paper holder - uchwyt na papier toaletowy - dom i jego wyposażenie
towel holder - wieszak na ręcznik - dom i jego wyposażenie
cake tin - foremka do pieczenia - dom i jego wyposażenie
chopping knife - tasak - dom i jego wyposażenie
chopsticks - pałeczki do ryżu - dom i jego wyposażenie
cutting board - deska do krojenia - dom i jego wyposażenie
gater - tarka - dom i jego wyposażenie
rolling pin - wałek do ciasta - dom i jego wyposażenie
sideboard - bufet - dom i jego wyposażenie
sieve - sitko - dom i jego wyposażenie
porch - weranda - dom i jego wyposażenie
staircase - klatka schodowa - dom i jego wyposażenie
blizzard - zamieć - zjawiska atmosferyczne
drought - susza - zjawiska atmosferyczne
dust storm - burza piaskowa - zjawiska atmosferyczne
heatwave - fala upałów - zjawiska atmosferyczne
avalanche - lawina - zjawiska atmosferyczne
tsunami - tsunami - zjawiska atmosferyczne
archeologist - archeolog - zawody
bricklayer - murarz - zawody
careers adviser - doradca zawodowy - zawody
estate agent - agent nieruchomości - zawody
forester - leśnik - zawody
glazier - szklarz - zawody
historian - historyk - zawody
jeweller - jubiler - zawody
locksmith - ślusarz - zawody
maid - pokojówka - zawody
miner - górnik - zawody
programmer - programista - zawody
scriptwriter - scenarzytska - zawody
solicitor - adwokat - zawody
surgeon - chirurg - zawody
technician - technik - zawody
therapist - terapeuta - zawody
