ang - pol - nazwa_kategorii - opis/zdj
amiable - uprzejmy - cechy charakteru
apprehensive - bojaźliwy - cechy charakteru
boisterous - niesforny - cechy charakteru
callous - bezwzględny - cechy charakteru
candid - szczery - cechy charakteru
churlish - gburowaty - cechy charakteru
conceited - zarozumiały - cechy charakteru
conscientious - skrupulatny - cechy charakteru
crabby - zrzędliwy - cechy charakteru
imperturbable - spokojny - cechy charakteru
irascible - wybuchowy - cechy charakteru
jovial - wesoły - cechy charakteru
plucky - rezolutny - cechy charakteru
prudent - roztropny - cechy charakteru
sullen - nadąsany - cechy charakteru
vigilant - baczny - cechy charakteru
zealous - gorliwy - cechy charakteru
whiteout - śnieżyca - pogoda
waterspout - trąba wodna
thaw - odwilż - pogoda
squal - szkwał - pogoda
precipitation - opady atmosferyczne - pogoda
outflow - odpływ - pogoda
inflow - napływa - pogoda
icicle - sopel - pogoda
evaporation - parowanie - pogoda
downpour - ulewa - pogoda
blustery - wietrzny - pogoda
black ice - gołoledź - pogoda
aurora - zorza - pogoda
anemometer - wiatromierz - pogoda
windsock - wiatrowskaz - pogoda
to acquit - uniewinnić - słownictwo prawnicze
affidavit - oświadczenie pod przysięgą - słownictwo prawnicze
cyclone - cyklon - zjawiska atmosferyczne
famine - klęska głodowa - zjawiska atmosferyczne
mudslide - lawina błotna - zjawiska atmosferyczne
twister - trąba powietrzna - zjawiska atmosferyczne
typhoon - tajfun - zjawiska atmosferyczne
volcanic eruption - wybuch wulkanu - zjawiska atmosferyczne
allegation - oskarżenie - słownictwo prawnicze
attorney - prawnik - słownictwo prawnicze
counsel - obrońca - słownictwo prawnicze
custody - kuratela - słownictwo prawnicze
decree - wyrok - słownictwo prawnicze
evidence - materiał dowodowy - słownictwo prawnicze
felony - zbrodnia - słownictwo prawnicze
grievance - skarga - słownictwo prawnicze
indictment - akt oskarżenia - słownictwo prawnicze
lawsuit - pozew sądowy - słownictwo prawnicze
litigation - spór sądowy - słownictwo prawnicze
mistrial - nieważne postępowanie sądowe - słownictwo prawnicze
negligence - zaniedbanie - słownictwo prawnicze
oath - przysięga - słownictwo prawnicze
to overrule - uchylić - słownictwo prawnicze
parole - warunkowe zwolnienie z więzienia - słownictwo prawnicze
plea - zarzut - słownictwo prawnicze
to revoke - anulować - słownictwo prawnicze
settlement - porozumienie - słownictwo prawnicze
testimony - zeznania - słownictwo prawnicze
trustee - kurator - słownictwo prawnicze
verdict - werdykt - słownictwo prawnicze
warrant - nakaz sądowy - słownictwo prawnicze
appendix - wyrostek robaczkowy - części ciała
artery - tętnica - części ciała
bladder - pęcherz - części ciała
collarbone - obojczyk - części ciała
larynx - krtań - części ciała
navel - pępek - części ciała
ovary - jajnik - części ciała
shin - goleń - części ciała
tendon - ścięgno - części ciała
tibia - piszczel - części ciała
tonsils - migdałki - części ciała
nostril - nozdrze - części ciała
calf - łydka - części ciała
nerve - nerw - części ciała
skull - czaszka - części ciała
insomnia - bezsenność - zdrowie
short-sighted - krótkowzroczny - zdrowie
injection - zastrzyk - zdrowie
diarrhoea - biegunka - zdrowie
vaccine - szczepionka - zdrowie
counter - pionek - sport i rekreacja
dice - kostka do gry - sport i rekreacja
favourite - faworyt - sport i rekreacja
foul - faul - sport i rekreacja
striker - atakujący - sport i rekreacja
hearts - kierki - sport i rekreacja
hopscoth - gra w klasy - sport i rekreacja
mau - makao - sport i rekreacja
rummy - remik - sport i rekreacja
spouse - współmałżonek - rodzina
drizzle - mżawka - zjawiska atmosferyczne
hail - grad - zjawiska atmosferyczne
hailstone - kulka gradu - zjawiska atmosferyczne
hailstorm - gradobicie - zjawiska atmosferyczne
whirlwind - trąba powietrzna - zjawiska atmosferyczne
beautician - kosmetyczka - zawody
blacksmith - kowal - zawody
bouncer - bramkarz - zawody
carpenter - cieśla - zawody
chimney sweep - kominiarz - zawody
counsellor - doradca - zawody
developer - deweloper - zawody
freelancer - wolny strzelec - zawody
midwife - położna - zawody
optician - optyk - zawody
physioterapist - fizjoterapeuta - zawody
prosecutor - prokurator - zawody
psychiatrist - psychiatra - zawody
stuntman - kaskader - zawody
translator - tłumacz - zawody
welder - sprzewdawca - zawody
